0000000000000000
0001111110000000
0001000010011100
0001100010010100
S110100011110100
0010110000001100
001001111000101E
0010000010001010
0011111110001110
0000000000000000